2
#,#,#,#,#,#,O,#,#,#,#,#,#,#,#
#,#,#,#,#,#,O,#,#,#,#,#,#,#,#
#,#,#,#,#,#,O,#,#,#,#,#,#,#,#
#,I,#,E,#,#,O,#,#,#,#,#,#,#,#
#,#,#,#,#,#,#,#,#,#,#,#,#,#,#
O,O,O,O,O,O,O,#,O,O,O,#,#,#,#
#,#,#,#,#,#,#,#,O,#,#,#,#,#,#
#,#,#,#,F,#,#,#,O,#,#,#,#,#,#
#,#,#,#,#,#,#,#,O,#,#,#,#,#,#
#,#,#,#,#,#,#,#,O,#,#,F,#,#,#
#,#,#,#,#,#,#,#,#,#,#,#,#,E,#
#,#,#,#,#,#,#,#,#,#,#,#,#,#,#
