5
O,O,O,O,O
O,#,#,#,O
O,#,#,#,O
O,#,#,#,O
O,#,#,#,O
O,#,#,#,O
O,I,#,#,O
O,O,O,O,O
