0
O,O,O,O,O
O,#,#,F,O
O,#,#,#,O
O,#,#,#,O
O,#,I,#,O
O,#,#,#,O
O,#,#,#,O
O,O,O,O,O
